11111111111111111111111111111111
10000000000011110000000000000001
10000000000011110000000000000001
10000000000000000000000001110001
10000000000000000000000001110001
10000000000000000000000000000001
10000000000011100011000001000001
10000000000011100011000001000001
11111111111111111111111111111111